CLOSE	K L OW S
CLOSE(2)	K L OW Z
DOOR	D AO R
DOWN	D AW N
HEATER	HH IY T ER
IN	IH N
LIGHT	L AY T
LIVING	L IH V IH NG
LOCK	L AA K
OFF	AO F
ON	AA N
ON(2)	AO N
OPEN	OW P AH N
ROOM	R UW M
SWITCH	S W IH CH
THE	DH AH
THE(2)	DH IY
TURN	T ER N
UNLOCK	AH N L AA K
UP	AH P
WINDOW	W IH N D OW
